111111111111111111111111111111
100010010000000000010001000131
101010011111111100000100010111
101010010000010001111111111101
101010000000010101000000000001
101000011110010101000111111111
101111100000010101000000000001
100000010000000101111111111111
111111011111111101000000000001
100000010001000000001111111101
101111110101000000000000100001
100000000101111111111000000101
100011111100000010100011111111
111110000101110010001000000001
100000111100010011111111111111
101110000101010000000000000001
101000111111111111111111111101
101000000100000000000000010001
101001100101111000000000000001
101100100100001011111111111101
101000100001101000001000000021
111111111111111111111111111111
