1111111111111111111111111111111111111111111111111111111111111
1000100100000000000100010000011000100100000000000100010000011
1010100111111111000001000101011010100111111111000001000101011
1310100100000100011111111111011010100100000100011111111111011
1010100000000101010000000000011010100000000101010000000000011
1010000111100101010001111111111010000111100101010001111111111
1011111000000101010000000000011011111000000101010000000000011
1000000100000001011111111111011000000100000001011111111111011
1111110111111111010000000000011111110111111111010000000000011
1000000100010000000011111111111000000100010000000011111111111
1011111101010020000000001000000011111101010000000000001000011
1000000001011111111110000001011000000001011111111110000001011
1000111111000000101000111111111000110111000000101000111111111
1011100001011100100010000000011111100001011100100010000000011
1000001111000100111111111111111000001111000100111111111111111
1011100001010100000000000000011011100001010100000000000000011
1010001111111111111111111111011010000111111101111111111111111
1000100100000000000100010000011000100100000000000100010000011
1010100111111111000001000101000010100111111111000001000101011
1010100100000100011111111111011010100100000100011111111111011
1010100000000101010000000000011010100000000101010000000000011
1010000111100101010001111111111010000111100101010001111111111
1011111000000101010000000000011011111000000101010000000000011
1000000100000001011111111111011000000100000001011111111111011
1111110111111111010000000000011111110111111111010000000000011
1000000100010000000011111111111000000100010000000011111111111
1011111101010020000000001000011011111101010000000000001000011
1000000001011111111110000001000000000001011111111110000001011
1000111011000000101000111111111000111111000000101000111111111
1111100001011100100010000000011101100001011100100010000000011
1000001111000100111111111111111000001111000100111111111111111
1011100001010100000000000000011011100001010100000000000000011
1010001111111111101111111111011010000111111111111111111110111
1000100100000000000100010000011000100100000000000100010000011
1010100111111111000001000101011010100111111111000001000101011
1010100100000100011111111111011010100100000100011111111111011
1010100000000101010000000000011010100000000101010000000000011
1010000111100101010001111111111010000111100101010001111111111
1011111000000101010000000000011011111000000101010000000000011
1000000100000001011111111111011000000100000001011111111111011
1111110111111111010000000000011111110111111111010000000000011
1000000100010000000011111111111000000100010000000011111111111
1011111101010020000000001000000011111101010000000000001000011
1000000001011111111110000001011000000001011111111110000001011
1000111111000000101000111111111000111111000000101000111111111
1111100001011100100010000000011111100001011100100010000000011
1000001111000100111111111111111000001111000100111111111111111
1011100001010100000000000000011011100001010100000000000000011
1010001111111111111111111111011010001111111111111111111111211
1111111111111111111111111111111111111111111111111111111111111

